fhv: tlm nmx fph zhz
rbh: fsh
jpg: nfl pct msg qlv
dfd: vkl rqk
cdd: ncv kvv lqh vfp
zjx: xcq ksz rbf
vsv: nxh fkf mgj krx
fdz: kgq btk fqr qsb szk gjq
hdb: qct mhp nmx rgh
fsg: dhj
zpz: jgz
npv: qzx
hkh: lqg
tkx: zks rzr jxb nkf qsn
bmt: jtf ccz
xfn: jgk hjm skd ckj
skm: zlb jsc ggc
cjx: fjs zlp rrp qhm tqn
pmf: jjf dml
gtj: hkh cfm ttv zlk rck
tdg: nxn mjs cvb
zsl: fpq lqz
nbx: qdk
stm: pcj zxf vnb zvq zks mff
zvz: kst nsg tlm lss
cjc: rrx slg
jnm: pxr dpf
mhf: vrx ccz ngb pxh
hlg: sbb pfj mbn dlq vmb
prd: zmt
zqk: fcg lxg rsq bvv
vmb: kjd xxm pjs kvl pql
bmx: jzb
vqz: ncl njc
hgn: mbh gqd grf
nvz: qdr
cgx: jls qph
hfb: msr jtz grf pvd bfh
hgz: mzg hdv
jdq: jvm bpp nnf
cns: kdm
kvv: pvg lrm
mhn: xrl ckj pxr rnj fcl
dzq: lnf qdb rsm ftk rbj
dcs: vfs
lpk: vnk vcj msr pql
drm: vcv shc pvd pxc
lrt: dkt
dlq: bch ksz vql
dhq: nsp
jds: rht lbb jkm mhj hnj vfv
shj: hbr gbl pds
rxs: qzn blc
cmg: nfl qqj szk rbs
dvb: szs qvr
bpz: fcv rsk tlt cvq
vsb: lkp ctv
nzh: sqj
lvt: bqs dmh
glp: mng
xft: bmx mvp
hfl: vkb tmf
xjp: pjl nxp cjs pcv
snf: vkl gcl csp gft
vkp: nsg qsv gkv jxk fhl
jfp: klv bmt ppk tgm
gqc: mkz sfb vsl hkm
jfd: nzs
xxm: xpk dhj
spg: qrf
qpr: mjs
gdh: lsx
rfz: pjl lhp fqr lfg hll
mrr: bvn bkf
vcj: kxl qgn tmf
pbv: dzv kbr nln pxd
qrt: zkv
kxb: jxj rgm gkc mzf
fvf: mdk nlh mvp
cmt: kbp bpq
blt: mbh lkp jzx xxg
dcx: ffj hhh hfx qhl
zxb: fxq hhq jqj vhf cfg jcv prl
hrz: tsl
xpq: tbp bks pkf kkm
thr: kmh vsr dzb gbg
rvl: pqf mmk kfz ltv
vst: jkb rlp qvr
lph: hxt
cxx: zfq gxm qhq
sck: spj drz
rmg: fdr nzs
pnb: gbq sgb bfh pkf
sqz: zch xhh ckj
ndh: chm qsn cjk qsk cjg
gfc: qvg bmt lbq fnq
sjp: crf
jtm: vrf rcp
txp: vvg
xtm: rrp sjf lxg tbv
jkj: cnn lhf kxx trj
xkk: gkd jxv kzb
nfk: mld lbx jkg ncd
smm: zvf vlk vbh ccz
shl: dxt hbs
tdv: rvk
mhc: mtd bdm vzr nzh fpg
ldl: ltd fpg
lbx: jqj flp qhs
zjv: brx gxx glp
frl: dlh shl pnx
xsc: kmc qxm bck svx
tvv: xct dcs jks kcg fqt
mmd: zpm
llg: gdd ftf
fhl: mjq ksd tzj
cgt: rnn sqn mkz dtn
cpn: tdv hgz skq snq
pxd: rrz
tbp: xct
xtb: hnr mqm fqn
zgh: sdk
txb: pjl qdz lcv fjq fbj nrb
nrz: cpt zgr
sbp: nlx brl njn rcd
qdx: hgf pcv bps gkn txp sjj
plb: kgm spj gxx
vrq: hcd tzn
plp: grc
cgv: tzc mng
vbz: tff lcv rlv nbn bnp
srt: bhv hdv zgh
cnk: phx jch tkt nsp vvt qdx
vtl: xqr crm vbn
tqn: mpk
pkb: pzq qph xcn
rpm: sbq nmr
svz: zkg qfv znl msn jpp
rcg: jvd
zfq: ckq cps
dhs: vpx dzv gnk
zsq: cfx tgm
lnf: mfq jxj lfk
kpv: hff zsq zbp xzn
qph: hpn psr ddh
rmc: ppc
jjf: lbc
gbr: vrb zgh
ksd: fsp jbq
tts: vvg bcd
gxm: zsk
jks: fxf szp qvg
vmt: qpr tzb xvt xmb
jzx: nlh hqm hcf
tsj: vsq cmj dqc
kfc: ltv vmp qlv dgz
bds: msr xcq gxq
xqs: kkz dkd lss qvr
xzl: qmp bfj szk
fvz: mqm vnb bsk tsl
blc: mrh
slc: kjd csn jss bnl
gqd: bct
xmp: vmr nnf mrr
jft: jgs rxv cpt
vzr: hpn
glz: qhs
xbk: btv qhq qkr xhn
fjm: pqf hbr plr
tmf: kxx gdb
gxv: lrt ggx
hsb: jgk hzt
mrg: ckt dph ftk
nsr: mgh xcd
tbv: rth lsx
vfk: cmm pgg glz
ddt: khf mqv glx csc bkt
sqx: cqv gdj pqp pbs
ldm: tgm
cjg: ljg drp
zrf: vrc gsn kvv vzr
czz: ght
shd: ldg nfl qhl gqb
jgs: gpn
cnc: xzq kfz ttc
ggj: mmd rjp spg
pxr: fsh gbq
xbh: fph xmp gbr nlh
rxv: pgk vfv
bql: jkg txp
jtr: hfs hpn hqh drz sqr
tff: fdn ffs xcn
qhq: glp
rdj: cln pnh ttc qkc
gpv: ncl cqz
vvt: jtm mjs
lfz: ght xcs
txs: bch mpp jnk
djh: ppk nbx
sfb: dxc ddm lnf
bvb: llg tbp
hxq: jrv fmf dpf jfd
pnf: psr czv bmz gpd
vxb: mrh kjh
rmj: vst
rvk: bhv
mfk: jxj vsl rlj cvm hdh
gvx: gpg tdd zlf prd
qpj: kgp ttf
nmb: rrl sth vgq vhg
bcd: ksf cln ddh jgs
nlx: kgp
zzv: cln qfr nrt grj
jxv: rsk xcn
hgp: zjv zqt stx xgm
lcm: ktr pcv cxx zbz gbl
krx: vsl mvp lrh
pdt: pds sqj rvv
ntn: qzx xtt
gfd: hmx ncs frn gpv
kkx: rsk czv vxk
lnr: qzx kst
hfs: lcj xlv
jtf: hvs
mpn: bqs qzn
hlm: nxh ppk mzf qlp
hfq: vdz
prl: cgx bqs
vtb: jmk qvm
gpd: hcd
kmc: xxf qzn sth
nxp: qxm
tpj: jtg vrt plm
zlv: gxq szs
mfc: bzh zfk qnm
xrm: gbm mpn lqh
hcf: dnb lhn lrt lkp
dtm: bnp ssb kdm gcn
jmk: spg
fkl: zpm
gbj: drz zcv lcj qtt nqk
msp: pfc qkx hff ptl hfq
mdv: dqc drl mng xjx kkx
fqz: fhl sjf fxg lss
fcg: bcq lkl
xtz: csn
hzt: zsq
rzr: kbp hfs jsn
fvk: fpr brx
vdv: rcd zlb krs tff
qzx: bhv
mbp: bpp lbq bch
lxg: hxt mfq
hbk: xrb pkc njq
csp: rht
sth: tgd jln
fvv: jgp zrh ffj sfg shj
sgp: pqk jzb pts
qqs: vpm prp jrz bvv
rks: mph rhz dqx
jxd: qdr cfg
cxc: dhj sms
ckj: kvl
bks: rlj
jth: vnk ksd drb dlk
pzq: lzr hfs
nln: fhb rvv
fjc: rcg nrr mtd lbb
gzc: jzx ztz
jxs: ldt ncj jbq
qzs: rpm hjn vqz jhb
lhp: jtm svx hzc
xth: zpm
zfk: qdv bbk bdj
mrj: xpz hsx lxx pnz msp
ttn: sbg
ncd: bdj slg szg
mll: lrh hlv dvm jtf vtb
tzb: qrt flb sqp
fqt: nlg tzh
vgq: brx lbc
qhm: sjt mhn fcl
ptl: snq tzj qdb
dbs: hzm xfr nml xrl
bpp: zzb
zhg: zvp hdh vgd
dkb: qsl
tdz: msn jdq nzf fpq frn
lbz: hxj bkt vbh
ldb: vpm kbm nhg jrz
mjj: hhq vzz prd
vfs: ggx csl jfd
qlp: fvt nmr nlg gxv
jxj: ppk
lfg: ghh
qdv: zqp
gft: cns dzv
xfc: gsr xrb tkr kdm
nff: nrt gqb vxz
mdp: gcl zfq rbq
lvs: xpx crm bzm rsr pxc ggj ldm
mbn: sdh
xfm: hmx nhg
dsz: bmz krb kfz
xdc: bmx kqp dhj kpx
zcs: flp
thh: zvq fzq qrt
lpg: vxz
ssb: grj vxz
bjl: sjp kmk pqk
mjq: jnf ttv
jtv: gpn lcp cjg vfq sfm
hvh: fpr xvt dpc bbs flb llp
mhq: bks grx zbm kxl
zgp: nnz nql fjs
prp: hfp zsl
jcv: grc fbj pxd
vhz: hmx
rbf: vmr lph
bbm: gvs bhn kkx dtm zcs
pct: rpx tff
tms: zkh nvf ksf
zsg: lcp lvp
ggc: vjc
ddk: nfg nbn
fvn: bvb lsp njc nkx
pkc: kng bdj
fqr: vfq
tct: cgz
pdj: jgk vrb
lqp: tck gsk
mcc: dvk zlk
xqt: ddx xhn
kcg: ppc
kpx: tkg hkm jgz
vkl: jtg kvk cns nln
hjv: cnh nbn kdm
qtk: hrq bnp njv hfh bqg
tkl: hbk pds rrx flp
qfv: zhz pjs
czq: qrf
zkc: xlf tms qpj xjx
kqh: pbv qtm mhg lmk
jpq: sms
kmz: tts trr xrc vfp fvk cxx
hzc: jvn pnh tct
qvx: bps tpj bbk fqp
qxz: dxc hmh jvm
fzj: ndp hjn dcs ztz
thd: jdn bhn dkc dml
vjd: zhx qxz zlk
xtt: bld
svx: qvt rpq
xrk: jnf pkm gqd snq
jgp: rkq kjz
ctv: qsl fsp
ckt: bhv
mnh: lqk fxf zrs
kdx: zhd qtt fxq gsr
vfp: plp
zsd: bvb fph fkl zgl
sfh: qsl
gpn: csp
nkg: qck czr pdj
kjf: rmj rvk pbf
nmp: htj cjc dlb xlv vtq
kbs: spj cmt
vgd: lsx bld
qff: vhz crf
jfl: qsl jxk
ldg: sqr
ssg: dxt jxj
mhp: dtb hfp
lkl: gbr kkz ppc
ncs: qrf dkj rpm
lpn: bct lfk rpp lgg
ltd: hjm
vks: nnk lnt szs ndp
hgb: xpz
slg: msg
dfr: vrf
pgt: bbg
fjs: kmk vqb qgn
sqd: rrz hrz tzn qhr
mtt: hzm ftf cdz vmf
rsx: zkh tzn cmj
nmx: mmg jzb fcb
npg: pxh lgg kst smb
qtg: zsl rmg
tbb: jpt zfs tct flk czz
ztz: gdh dhj mvp zdk
lhs: cvl vgd frq rbh
bkt: dpf
pql: zjx xth
hdx: dbl xtq glp qns
pdn: dzb llp shx
pfs: gnq
jnk: bqh spg njc cdg
tkm: xkk brz kgp vjc plp
cvb: ckq kqk
ngz: bff vhf hdz cfg
hll: nfg hdz rvv
mhg: cvb mpn
kjk: mfq cfx qqq qgn
gcx: qsn jsn
fhh: jxb qtk fhb xlf tpb
bvv: ttv qrf
vqb: dlk cnz
lqv: cnz kcg hjn mvn
tpg: prt kqp qvm
rck: nlh gdd lnr
hjn: psp
jln: rlx
jts: jfq
gsk: ssn
qsb: fjq cps
pgk: rch
lcv: ght fnl
hqr: rlp frq ssg dvb lqz
nvf: jxc
xpx: vmv mrr xtz
zkg: nml qvg ncj
bvx: nxp xmm qhz skh
qkq: grx cqz cdg
jkd: jft vqm hjv hfx
mpq: cdz
bht: gpd jxv tmb sqd
tch: hps dds qqj fzq
sgb: gdb
kgq: gft
cvj: ndp rnj ksx
pjh: pkf fpq tmm gmg
tlq: hdk vxm stx
hjz: fpr kmh tgt fnm
rqv: mff vrc rmm vph kqh qzc psr
jhb: clb mcc
lcc: fdd lrt rpv
svt: cln kgq gnq bfj
hbx: tns
crf: hss mdk
cqv: pxc xtk pdj
cmm: xpr spj
cvv: mqv jfl lkp msv
npm: pvg gcx fcv xqt bql njq
hps: zfm
lxx: prf
zvp: lqk fkf lqg
gvb: cps jpg lcp fqq
ckq: jxc
gxx: xgm rrz
xxb: ljr znl ncj
zzj: fcx khd kxx
hjm: jtz
zcf: dxb flx vrb gpv
vlc: xtm cqj tqn mcg
qdb: dkt
fzp: zlf cnc kqk flp xcs
gcg: vsl lss hgz
jhx: nkx szs vcv
kxp: dhj
zqm: kvk gbl vds
pkx: mvn fdf bld kqp
kds: gcg rvk gxq fsg tlh
mff: lcj
brl: hnb glz
plr: zlf
znl: gtn sjt xtk
tgt: bkd txp slg
zhn: rmc qvm dhj
sxq: njn tns kvk vrt
lgg: tdv rsv fsp
bhn: pkb pvg
qkc: hdk nsp ldg kgs
tzj: prt qvr
gnk: tsl
zrq: skm nvz rcp
vhf: mhc nxp qmp
dnr: lsx zhz
skt: ddx lcf
zlk: lvh bpp
bfx: kzm kkq vtr ptl
kgm: tgd qxd zkv
njg: mqm vdx jxc pcj
cnn: ncj tjg
vjc: rht
mcn: zsg hnb xrm qhz
kjh: cgx ddx
vsr: vqm kvk pkc
dpc: tzc ssf mgr
cdg: jfq rjp
hnr: fdn hfx
lbf: gqd dtb sjp
cmr: bch
scs: rgd mpk
vfq: qnl
sjt: lqg lmf
ljj: cst pqf rbs dkc
nkz: fxg fvp xpk
dbz: rht lcp zvm cmt dlp zqm
chc: ptv xzz jts hbs jbq
rdc: hqf vds psr qtm vhg kpd
csl: msr
lff: kgp tjc tch csp rnm
skh: dkg rvq kng rrx ktr jhh
jch: zmt skm nff gpn prl flk
cmz: bql zkv pzq
npz: jvm fvp zsq fxg zxp
qbj: qrp lqh sqd jkm
chm: bmz kqj jtm
pfp: tkm bsk cgv qkr
vxk: qxm
qlm: ggc bcz cph nfk
dlb: hdz mqm btv tbd
vzc: kgs psb tbd xlv
php: jts zzt gdd
fhm: fdr kqp fcl
qsk: qtm
vcv: lfk
msv: njc xth
tzn: khh
qsx: sdv blc dlg hps
qjv: lvh zdk
qhz: tdd prd tkk
qjs: rbh rgh kxc dkb
vhg: cgx brc
zcx: nrt tlq sfm fjq hrz
bbz: ncj kxl
mph: ddk xmm ghh
pfn: mgh lvf nlv
xvt: lpg
mvf: prd sdr sjj nvm
jzd: lqp qpr xff
zzt: hss vql fxf
dqc: lpg nfg
ljr: fkh tmf rnj
fqm: hxt dlh jbv qct
skl: ghh flb
nhg: dnr
qzc: fqn jqj nmg
mqq: djh cqm txk dkt lxg
xhz: czq qxz zvp hvx
nkf: mdp lgd jjf jxd
vrc: rch flq
mmh: tkg cnf rmc psp hvs
cvm: pxh lbq
rkv: kld xtb qph dhq tbd dkc
pvg: vfv
qfs: zmt trr
vrs: mgr zgr cnh lgd
jkb: xth sqn
sjj: qsb nxb
rlm: mcg qvm
vbc: jsc knd
nnk: hjr hss skq
vqm: rvq
vng: ktr nlx fjc vkl
dlh: fvt cnz
nqc: fkf ppc jfd
srn: tkk rlv dlg
hfh: rqk grc fxs
fnq: dng hkm vcv xfm
prj: qjv smv frl
xff: rch
tqf: rpn zmx stx pmf
pnh: xgv rcg zlb
clb: rnj gbq tzh
dng: dpf rbf
jzc: jbv
qnz: zgg sth krb kll
tjg: ntd scs vrb
xmn: sfh cvl vkb
bsh: mpk qct ndp mll
nqk: ssf fzq ngr sfm
kzg: xvf snl llt pfn
rcp: zqp rpx
sdr: bbk
pzs: nlv xsl vjq qhk
vqt: fkn rlm cbf hff nlh
rvm: vpm dvb jjb rmj
bxp: lzp qck xjq xpk
qnm: qjz xmm
tbd: czz
flq: fhb
jkm: fqn
dxb: lxx rbg mpq
gsr: hbr vjc
pnm: lcf bbg
tlh: gkc mrg cvl
fcx: zzt pjs bhx
cst: vjj cgz vxm
ltv: gsn cpb qnl
rst: qgn tbp pnz bjh
rnm: lpg zlb
zvm: ggc pfs mhj
cpb: hrz rpn
kld: flq xxf cmj
gkn: fpg hnj
sdh: qqq
xrb: qfr
zqt: kjh gxm hfv
vqv: tkk jsc dzb nbn
qmh: dtn xzz llq sgp
fqn: sbg qtm
llt: qks pvd cqv qjk
dqm: rbj kxc ldl ldm
gxq: hmh
mvl: fdd xqr rjp zlp
qtz: csc
cfm: jrv msn
sbb: lmf
fqp: dfd grt mng cjk
tqc: brx bkp zrq ssb
qhr: xqt
zdk: xpz
mkz: fxf
bnl: hmx gdh fbg
qvr: fvf
lhn: nlx zlf qtm
nnp: pts tgl
xhn: ckq
lvf: tgm glx
xhh: dfg jfq
xgt: ghk cmr zhr vsl
qqj: zqp
lqk: mbt
rrl: szk dfr kbs cnh zgf
cbf: vmr
mcg: cxc
llq: hfl nsg
rbc: hps qqj sqj dbl
nzz: vmr fbg fdr
hhh: gmx vxb
frr: tmj pxd nrr sqd
pkj: gsn ghh bpm
snl: vrb dbk vmf
lxq: hhq nrz ffs rrx
rjc: cgv bpq hnr mjj
zvf: bjh lrh mcc
tmd: dnb qjk hfn
hrs: xtz nnp llq fhm
dxr: pfs zkv skl
qck: qct
hdc: ssn ttf fqj qfr tch
pnz: bch zpm
lvj: gkc vsl kcg
hfn: tdv ssg fbg jfm
qrf: dkt
pkf: lcc
hbg: nkg rbg scs zdk nsr
gph: bks dph dtn
rrg: cpb glp nvz
rgz: sdk cmr qkx
bsl: cmt vxk dzv zsk
hnz: fkl pql lqz hdt
xmm: dds ttc
xcs: rlv rvq
frn: cjd lss hht
jph: sfh zbm ntt bkh
chn: nhg vlk cmr
sjk: tms nzh qdv
jls: pfs dzv
tmm: ccz
tkt: qns
smf: tts vgq qtt pfm
gql: flx jhx sjp jks
lbd: vpm qqq tgl khd
vdt: flb bbg hhj
knh: vdx jkm vfq
dtn: hvs gfj zzb
hqf: qdr rch
dxm: ttc nll vfq vjc
hht: lbf tlh mvn
kxl: hfp kxp
ldt: lnr vrb sjf
bzq: zmt knh dqx tjc
crm: pmp
jkg: vrf
kgj: zhz bbz vbn qkx zsq fjs
tpb: rxv gnq qkc
rbg: hdv
lqd: cmr msp ddm vlk
zgc: nvm tts flk ffr
brz: nxb rch lzr
rcn: rlp spg qff lfk
jdn: lzr
jdp: mmk hnb vbc dbl jgp
lss: vsb
qkm: pkj zcs bcd qdr
bdj: pnm vpx
xxf: kng zgf bff
qdr: rqk
lqm: kgs lpg zmx
rkq: ddx zkv bdm
rnk: cln kjh dfr dfk
vlk: pjs xrl
qxr: kkz msv fqt msn
cjd: vrb bmr
fbj: qpv
sjb: mgh pmp bhx tql dkj
qxh: rgz dlk
ghx: nrt brl qfs vgq
vgs: hqm ssm xtz ckt
dnb: zpm dvb
rnq: gmx rhp dfk nlx
zhm: lbz rpm bcq tvd
cdz: ckj
kft: vtb vkp qtg jpq skd
mvt: txs cvm pbr dph
tdd: lfg xff
vzz: plr
lzp: kkz csc rmg
phx: lzr zkh btv
qjz: flq nvm tns
lgd: pcj cfg
hnx: nbx gzc mbn skd
nmg: cnh mld xmm
cfd: jrm zxb gsh hcd
rqm: qpv chm qsn vhg
fdn: mmz dml
tgd: gcx
rrx: cjs
pbr: lvh vbh ntd
kkg: gbm ggc xff
lrb: cjc pbp ddk mrh
xpr: zxf hpn cns
fsk: hbs zpz php fdr
kvr: xrl dxt prt tql
pqf: gpg
bkh: ntd zgh
hdk: cln rpx
zgl: fsh jzc
hnd: lqk xtk dvm
kkm: kxp nkx
ccg: qks lfk qck zlp ldm
cjk: gjq xgm
pgz: czr jmk gtn
qcd: jss dhj bzb zpz dkb
bvn: mmg jzc
mgh: hzt dpf
zvl: prf jnm vmv psp
txx: tmf rdb jnf jrv
xcn: dml
tlf: hdv tpr fkl crm
jhr: ctp kvl grx kbm dng
bqx: gsk fpg rjd kbs
zxf: fhb
tmb: llp vxz jds lcs
brp: pbf hgn xpk hlm
xrc: cph lrm
snj: szg vrt jdn qlv
bkd: bck nrr
hqh: knd ljg plr
dcm: ntd bzb rgm
mnn: xfn hnt flg skq bpt
dfg: bmx
bhx: bzb
vrx: khf rsq pxc
lhf: hxj lsx qqq mpq
bcq: jmk tbv czr
prt: jkx
fjf: ghs drb lpk mzg qfv
qlv: vdx
dzx: kxx bbz jts
cqx: prm hlv kft jxs
fpl: nrr jvj vdt
qss: bql bpm sfm bcd
rsm: cjd nxh
bkf: lmf llc
nlh: bzm
kqj: qsn mrh
vph: cjk bkd ncd
zrh: kkx bqg cps
bcp: sdh rsq rgm lrt vnk
lqg: gdb
ktr: bqs
fdf: jrz gph ztc nkz
pgg: qsk hhj gcl
xcd: xtk zgl
jjb: cfx kxp
bpc: pbs dqm vsg jjb mjq
jtg: mff xgv
zks: rvq
tbn: dxr srn xtq prd
rgh: dtb bld
jzb: zpm
vjq: vnk dlk hnt
drb: csc fmf hbs
hnt: cbf rgd
sfk: vtl qsv nsg gbf
zmf: jxd qfs vsq kfc
zfs: ttn vxb nvm gjq
pfc: fxf
rnh: tzn mhg ssb
nxn: cst
zgg: tmj lbc
jgb: lhf lgn ptv kpt
mqh: gbr kzm rsm vsb
zcv: vrq kmh pdn
zhd: dbl btk
gdd: vdz ccz
krp: jvn rvv blc pgk
rth: hlv crf rpp
rrp: dnt kst
fqq: lzr zfm qhs
bcz: kfz
ntt: gbr qsl hgb
fcb: bkf jzb kvb
bqd: rsv rnn kvb
mpp: gdd rgm
cqz: mmg jgz rsr
shf: khh jsc cnh jkg
gjc: hxt mvn qsv zsd
nnv: hlv hxt ggx rsv
shc: rlp lqk
ffs: ckq
vmv: hcf zbp
trs: tmd qsl hxj ttv
csn: vmr bmx
hvr: dzx sqn tzj lgn
tsl: glp
fnm: sqp xjx rxs
tmh: gzc chn zrs tpr
hmh: kst
hnb: vvg
rcd: jtd
fnl: qmp qrp
sdv: mjs hnj gbm
gcl: jxc
dvk: qqq xpk zbm
gkc: dtn pkm
gsh: fvk rqk
xxg: nnf lmf krx
zxp: tqn vcv
jnr: hjv zkh lvt qns
ncv: bdm jls tzb zqp
npf: ttn ttc
pqp: qvg cdz
smb: hcf fmf bmp mmd
dqx: krb ksf
cnz: hqm
xgv: sqp
flg: xcd lph
qhk: qdb kvl qdk
qks: ncj dfg
bfh: rbf
ngt: bjh zsd mrj sbb
fcl: bjl ftk flx hjr
llp: bbg
hrq: vnb lgd zkv
zhr: ltd dfg
qkl: pcj lqh jsc
pmt: zhx tql hgz sbb
grf: vbn dvm ngb bbz
zch: mbt mgj gdj
vkb: mbt
drl: mzr jvn jjf
rbq: czz rhz ttn glz
kll: lbc jtd ffs
ssn: mpn
rnn: mpk
qkr: cgz pkj
prf: vdz
kzm: scd hzm msp
dlg: tgd tzc
txg: cnn nqc qjv pts
jvm: ntn
vxm: mrh rcd
nnz: dnt kqp zhn
dgz: mzr
nll: kbp hqf shx
tlm: ptv
lgn: zlk scd cvj
nnf: dph
mnd: rhz rrg zfm
dmh: hhq tmj
bqg: zmx
xkr: bql zcs zgf pgt bqx
hdt: lqg tmf
jnf: rpp pfc
krs: mkl xmb qxd
sfg: shx bnp
lqq: zhx vlk hjm
txk: srt gdh tql
kjd: cvl ncl
qxd: ddh
hkm: vbh llc vqz hfl
krz: kkg plp mnd kzb vbc
lcs: hdc nbn brc
xvf: jbv rsq srt
gmx: qhs hhj
dbk: bkt php xxm
btk: vvt hcd
tvd: ggx cfm sgp
ngb: vtr gbq
grt: skt sqj hhq
lvp: tzn xtq knd
ngr: rlx rxs gsk
ncx: zpz mnh bmr
bvd: sdh xft ctp bpt
bxs: pjs hsx dkb
hhj: sbg
klv: pkm gfj fcb
vtr: gtn gfj mdk
nls: hgb bzm lxr mzg
jss: mbn dnr zxp bfh
xzz: kpt mbp
mhj: plb pgt ssn drz htj rnm
dgx: bsk jtm shf qtt
pnx: fvp jkx qdk
mgj: mvn rlj
fcv: sck sfg
dkg: xzl hds btv rnh tsl
xlf: htj
xrn: pgr pfm
bln: vpm pqk jfm
ztc: nzs fkf mmd ctp
rkh: rgm rnn bkh lvj
stt: jnm lvs dxt zzb
qcn: pnm xvt
mtd: kgm
lnt: szp bhx
qxm: kdm
nvd: cxc prj nmx dlq
ssm: rpv lrh
vfd: sdv hfx jvd mfc
nrb: qrt nxb
fpg: zsk
mld: mzr czv
cpt: czv fqq
gcn: bsk dgz
kpt: fmf
prm: chc jfm nlv
rdb: hdh qff gdj cdg sdk
ghv: gsh nxp plp pnm jgs rzr
dlk: jrv smv
hfv: jds jls lqm vrq
mpf: sgp jrz gqm lph
vdx: qrp
hvx: sqz vlk hkh
trr: dhq nvz cpb
zgr: ttc nvf sqp
bmp: qtg xhh
kgp: dzb
nkx: bks
khd: jbq
vkx: kjf qtz qct qhk hck
mqv: kpt bqh
hzk: dcm shl nmr trj vdz
mbm: lnt rlm sbb cvv vgs
dkd: sdk ctv sjf
glx: gdj fsp
flx: csl
qvs: pxc hbs rgm
fhn: nmv xmn nsr kbm
gvs: mzr qqj dqx
ttx: zsl nlv ksz ztc chn
bmr: fsp czr bld
vtq: sbg dlg gcn
pbf: tmm prp
gfp: jxk jbv pqp
vsl: skq lbq
nzs: hvs
frq: tmm gbq jkx zzb
rsv: pbs fvt
xzq: qxd hbx kjz qfr
khm: bhn qsk llp vds rsx hnj gft jsn
bhc: nrb gjq xvt bdm lbb
bzh: bcz fnl drz
kkq: fsg jpp llq
tgl: gkv cnz pfc
drp: nsp zvq kqk
gqm: gkv bmp
cmq: vfs hbs nzz bqd bvn ckt
msg: kgs flk
pfj: nlg hxc ltd
dkc: dhs ssf skl
hpd: gnk tch zks
fvm: zxf gpg hds jzd
dfk: rrz
pjl: nvm lqp cpb
mrc: dkm jpt zhd smf
skd: ngj ssg
cnr: mjs lff lrm vzr
ftk: jts
qns: tns
nml: hqm
tkg: fqt vmf
lqb: btk rlx zsg gxm xmb pbp cmm
lmk: hdz qhq
tkk: rsk
lsp: cbf mpp chn gdb
nxk: dfk nnp hzt hdt zzj
ncl: xpk
jrm: kfh lvp tsj
mmz: vpx
nql: thp nml mnh
fqj: qpr cst tzc
mkl: nzh tkt pgt
njv: skl cps
brc: szg ljg
jvn: dds zbz
cxn: tpg ncx zlv jtz
njq: kmh
kjz: gqb rqk
cnf: hjr cfx ngj
szr: dlh mhn lvf bkt
gsn: cgz rpn
rpq: jpt njq fdn qhr
fkh: fvt qtz pmp
hmx: fdd
lvh: tmm
tjc: bcz dfr
gqb: xhn dhq hnb
qxb: bfj cns gnk cps
jbj: ksf rpq mmz
bpt: ngj nzs lsx
bck: sck pct qrp
mbh: fpq fbg
nxb: grc
hff: szp
gbg: dqx xkk psb
blf: kmc gkn fxs bps
dnt: vmf qkx vql
rng: rjp vkb mcg zhg
qlx: kbp bmz bps kng
grx: nbx gxv rpv jtz ftf
thp: clb nlg pgz bds
nmv: fsg jtf pqp
tlt: msg
knd: qpv
fkx: hkh qxh lqz jss
stx: pds bfj
hjs: pxh prf npv nqc zlp
shx: mrh lcf
vjj: zks xhn vfv rch
jrq: cjs vqm jcv nrz
xjr: rpx qcn
qdz: xlv qpj czz
jsc: qnl nvf
vmp: jqj lfz kgm
fxs: qfr nln tdd
xtq: qpv grj
fpr: xff
xct: pkm nzs
nmr: bjh
fkn: ldl rnn rpp lvb
vhm: pqk kcg rmj hjr qvs
rjm: qxh zbm pnx
qng: tlt rqk kng sdr
zsx: lbf gfp vhz
mfq: lqz
tpr: jfl sgb
npq: xtt czq bct xxg nnp
tqd: xft hgb xjq rbh zhn
lrm: rpn
tck: qpr jln
vxt: ldg psb dxr sjk
bzb: tlm
kpd: gnk fdn hbr
nfl: vjj
rmm: jtm npf xrn
ndp: xtt
qvt: jpt sdr ljg hbx
fmb: sjf pmp dxc bpp bld
ntd: psp
rhp: tdd jln jsn
xsl: llg bln lxx
nxh: dhj scd
qbz: cmz dfd zgg vpx
xjq: kkm rgd nbx
cnl: zcs gmx qhs
jhh: bpm xjr rlv zbz
zmx: jvd kqk
pcv: sqr
jvj: jvd skt hhq xrn lvt
xzn: rbg kmk csl
htj: mtd tgd
znr: ppk rsr jjb fvp
cvq: fqr kqj vfk
vql: hfq
qjk: lzp jpq
xcb: zsk rnm qhq qcn
sbq: gtn njc fsh
llc: vhz mzg csl
khh: jsn qzn
nvh: kxx zkg bvd kmk
tcx: mpk lmf jtz xcq
bbs: xgv ght tlt
dkj: mhp fph
ffr: pdt jtd ddh qhr
sms: crf
xgm: ckq
lqh: bpq cmt
cph: xcs grc xlf nxn
gbf: hnd gfj dcs
kbm: jhb flg szp
njn: qnm lbb
ftf: kqp
plm: czv fjm tkk
hgf: kzb jtm fbj
szg: cnh
zbp: xtk czq
xjx: tff
dkm: vnb pds gpd vzz cmj
rlr: scp fhb rbs qdv
dmr: zbp hzm ksz pvd
bgl: tmj njv lfz
nzf: sms xrl
pfm: kzb dmh
bpm: srn
hds: qnl czz
mzf: nks zhr
kbr: pmf tsj nfg
vpg: zsx qsl kmk kxc bct
dlp: jrs gpg zgf
zzs: pgk vzz hfx grj
pgr: dgz psb jxc
kfh: rcg nrz vfp
jpp: sqn rgd
vmg: xfn rjm qdk qkq
pqc: dzb nxn bbm jkm
gbl: pfs
ngn: dsz bgl jdn lfg bnp
rbj: krx jrz
xcx: hjn ptv hsb nzf scd
rjd: cjs gcn bck
pts: ttv dtb
vmr: mdk
lxr: bpt npv dpf
jrs: qnl pgg jpg
ffj: tck fqn
pbp: vvg
gkd: hpd xmb njg kmc
fxq: drz qmp dds kgq
mgr: nrt bbg
vrf: mmz
scd: jgk
vsq: hhq hcd hbx
jgz: smv kxl
gbm: fdn
tpc: vxk spj tct ssf
nfg: kmh brx
jxf: cnl lmk xrc fpl
hsx: ngj hfp
xqv: jbj hhh hqf qnz
xqr: bpt hgb qsv
lvb: mpq zlv zkg jhx
ttf: qns lcj
zvq: kbp
pxh: lnf
ddm: hmx mkz
dvm: pkm
nks: dfg fdd jpq
ghk: dxc ddm qtz ndp
rbs: gnq
snq: qvg
bxh: smv xjq zhx zgp
hxc: ntn kxl hfq gkc
kvb: ssg rmc
cqm: fvf lqq qhk gkv npv
trj: xfm fxg
mmk: zfm rlx
tkr: zxb fjq rks bpq
kcr: qhl tkt bbk pbp
hdh: tpg
cqj: bxs fcg jkb
jxb: bqg rhz
dfv: vqb xxb pbs djh
qpz: nlx bbs qnl jjf
jrv: rgz
xfr: sfh shc ntn
vsg: lrh hss lnr
khf: hmh mbt zhz
hxj: jzc
bss: vfq xfc jtd qkl
hck: rpm vjd hsb
ghs: ckj xcq zrs
bzm: rlj
vrt: cst tdg
bkp: lcf npf thh xtq
bqh: jfq vbn
tzh: mmg nks
jfm: rpv
pqm: tzc bsk pmf xjr
nrr: qhl lcj
rsr: kxl
bpb: hfq ssm khd bds sgb
ksx: crf zlp xpz
scp: zkh sqr vds zbz
stn: xrb xcs lhn dlb
gmg: fqt gqm tmm fcx
bff: fzq krb
qvm: qqq
zrs: bqh
xmx: jkx kxc ctp jxk rpp